#########
###   ###
### # ###
###X#R###
#########