##############################
##########        ############
##X        #####    ##########
#####  ########      #########
#####  #######  ####  ########
#####  ######          #######
#####  #####  ########  ######
#####  ################  R####
##############################