########
#R##  X#
#  # ###
## # ###
##   ###
########