############################
#R#                        #
# # ###################### #
# # #                    # #
# # # ################## # #
# # # #X               # # #
# # #                  # # #
# # #################### # #
# #                      # #
# ######################## #
#                          #
############################